1111111111111111111
100000010000000C001
10010111P0110111101
11C0000000010100001
1E000001000100011C1
1111111111111111111