11111111111111111111111111111
100000010000000C0000000000001
10010111P01101111000000000001
11C00000000101000000000000001
1E000001000100011C00000000001
11111111111111111111111111111